AZTEC TWO-STEP - Adjoining Suites\AZTEC TWO-STEP - Adjoining Suites
BAD BOY - Back To Back\BAD BOY - Back To Back
BARNABY BYE - Misc Trax\BARNABY BYE - Misc Trax
BITTER PLEASURES - Eat the Monument (1983)\BITTER PLEASURES - Eat the Monument (1983)
BLACKJACK - Blackjack\BLACKJACK - Blackjack
D. BEAVER & THE COMBINATIONS - Combinations (1973)\D. BEAVER & THE COMBINATIONS -  Combinations (1973)
DETECTIVE - Detective\DETECTIVE - Detective
DIAMOND REO - Dirty Diamonds\DIAMOND REO - Dirty Diamonds
DIRTY LOOKS - Live\DIRTY LOOKS - Live
DOUCETTE - Mama, Let Him Play\DOUCETTE - Mama, Let Him Play
EGGS OVER EASY - Good 'N' Cheap\EGGS OVER EASY  - Good 'N' Cheap
GARY HERREWIG - Gone Conclusions (Artful Dodger)\GARY HERREWIG - Gone Conclusions (Artful Dodger)
GREG KIHN BAND - Glass House Rock\GREG KIHN BAND - Glass House Rock
HARD STUFF - Bulletproof\HARD STUFF - Bulletproof
HEAVY METAL KIDS - Anvil Chorus\HEAVY METAL KIDS - Anvil Chorus
HEAVY METAL KIDS - Kitsch\HEAVY METAL KIDS - Kitsch
HILLY MICHAELS - Calling All Girls\HILLY MICHAELS - Calling All Girls
HILLY MICHAELS- Lumia\HILLY MICHAELS- Lumia
HUDSON - Damn Those Kids\HUDSON - Damn Those Kids
HUDSON BROTHERS - Ba Fa\HUDSON BROTHERS - Ba Fa
JIGSAW - Jigsaw\JIGSAW - Jigsaw
MAYDAY - Mayday (AOR)\MAYDAY - Mayday (AOR)
MIKE PATTO - Voice of the People\MIKE PATTO - Voice of the People
MISSOURI - Missouri\MISSOURI - Missouri
NANTUCKET - Best Of\NANTUCKET - Best Of
NUMBERS - Add Up\NUMBERS - Add Up
ORBIT - Orbit (1973)\ORBIT - Orbit (1973)
ORIGINAL MIRRORS - Original Mirrors\ORIGINAL MIRRORS - Original Mirrors
PAGLIARO - Rainshowers\PAGLIARO - Rainshowers
PEZBAND - The Dee Harris Songbook\PEZBAND - The Dee Harris Songbook
PIPER - Can't Wait\PIPER - Can't Wait
PIPER - Piper\PIPER - Piper
REGGIE KNIGHTON - Reggie Knighton\REGGIE KNIGHTON- Reggie Knighton
REX - Where Do We Go From Here\Where Do We Go From Here
RICK DERRINGER - Whisky-A-Go-Go February 1977\RICK DERRINGER - Whisky-A-Go-Go February 1977
ROADMASTER - Sweet Music\ROADMASTER - Sweet Music
ROBERT HAZZARD - Vinyl EP & Wing Of Fire (Vinyl)\ROBERT HAZZARD - Vinyl EP & Wing Of Fire (Vinyl)
ROBIN TROWER - Winterland 1975\ROBIN TROWER - Winterland 1975
ROCKIN' HORSE - Yes It Is\ROCKIN' HORSE - Yes It Is
SHANE CHAMPAGNE BAND - EP\SHANE CHAMPAGNE BAND -   EP
SHERBERT - Howzat\SHERBERT - Howzat
SLEEPY HOLLOW - Sleepy Hollow\SLEEPY HOLLOW - Sleepy Hollow
SPARKS - Bottom Line New York City December 1976\SPARKS - Bottom Line New York City December 1976
STRAIGHT EIGHT - Shuffle 'n' Cut\STRAIGHT EIGHT - Shuffle 'n' Cut
STRAY - Stray\STRAY - Stray
SUSAN - Falling In Love Again\SUSAN - Falling in Love Again
TALKING HEADS - CBS Demos 1975\TALKING HEADS - CBS Demos 1975
TARGET - Target\TARGET - Target
THE ARCHIES - Everythings Archie\THE ARCHIES - Everythings Archie
THE BOYZZ - Too Wild Too Tame\THE BOYZZ - Too Wild Too Tame
THE COLORS - Rave It Up EP\THE COLORS - Rave It Up EP
THE DODGERS - Love On The Rebound\THE DODGERS - Love On The Rebound
THE FLAME - The Flame\THE FLAME - The Flame
THE FLYING CIRCUS - The Flying Circus\THE FLYING CIRCUS - The Flying Circus
THE FOOLS - HEAVY MENTAL\THE FOOLS - HEAVY MENTAL
THE FOOLS - Sold Out\THE FOOLS - Sold Out
THE KIDS - Pop N Roll With The Kids\THE KIDS - Pop N Roll With The Kids
THE MOTORS - BBC Radio 1 In Concert 1978\THE MOTORS - BBC Radio 1 In Concert 1978
THE NECESSARIES - Event Horizon\THE NECESSARIES - Event Horizon
THE PRIME MOVERS - Matters Of Time\THE PRIME MOVERS - Matters Of Time
THE PRODUCERS - Demos 1983\THE PRODUCERS - Demos 1983
THE REAL KIDS - Demos 1977\THE REAL KIDS - Demos 1977
THE RECORDS - Man with a Girlproof Heart\THE RECORDS - Man with a Girlproof Heart
THE ROLLERS - Voxx\THE ROLLERS - Voxx
THE RUMOUR - Max\THE RUMOUR - Max
THE SPECTRES - Stories EP\THE SPECTRES - Stories EP
THE X-TEENS - The X-Teens\THE X-TEENS - The X-Teens
THUNDERMUG - Thundermug\THUNDERMUG - Thundermug
TOM DICKIE & THE DESIRES - Competition\TOM DICKIE & THE DESIRES - Competition
TOMMY TUTONE - National Emotion (1983)\TOMMY TUTONE - National Emotion (1983)
TRICKSTER - Trickster\TRICKSTER - Trickster
TRILLION - Misc Trax\TRILLION - Misc Trax
TROOPER - Trooper\TROOPER - Trooper
TYLA GANG - Yachtless\TYLA GANG - Yachtless
VANCE OR TOWERS - Vance Or Towers\VANCE OR TOWERS - Vance Or Towers
WEREWOLVES - Misc Trax & Live\WEREWOLVES - Misc Trax & Live
Z-ROCKS (1981)\Z-ROCKS  (1981)
ZONES - We're No Angels\ZONES - We're No Angels
ZZ - Surprise Misc Trax\ZZ - Surprise Misc Trax