ADVERTISING - Jingles 320.zip
AIRWAVES - New Day.zip
ARMOURY SHOW - The Singles Collection.zip
ARTFUL DODGER - Babes on Broadway.zip
ARTFUL DODGER - Coffee Break Concert 1980.zip
AZTEC TWO-STEP - Adjoining Suites.zip
B.A. ROBERTSON - Bully For You.zip
BAD BOY - Back To Back.zip
BARNABY BYE - Misc Trax.zip
BITTER PLEASURES - Eat the Monument (1983).zip
BLACKJACK - Blackjack.zip
BLUE - Blue (1973).zip
BLUE FEELING - Blue Feeling (1975).zip
BOOMTOWN RATS - Live March 1980 Boston .zip
BRAM TCHAIKOVSKY - Paradise Theater, Boston 1979.zip
CARTOON - Misc Trax.zip
CHILLI WILLI & THE RED HOT PEPPERS - I'll Be Home.zip
D. BEAVER & THE COMBINATIONS - Combinations (1973).zip
DETECTIVE - Detective.zip
DIAMOND REO - Dirty Diamonds.zip
DIRTY LOOKS - Live.zip
DOUCETTE - Mama, Let Him Play.zip
DUCKS DELUXE - Ducks Deluxe.zip
EGGS OVER EASY - Good 'N' Cheap .zip
GARY HERREWIG - Gone Conclusions (Artful Dodger).zip
GREG KIHN BAND - Glass House Rock.zip
HARD STUFF - Bulletproof.zip
HAWKS - Hawks.zip
HEAVY METAL KIDS - Anvil Chorus.zip
HEAVY METAL KIDS - Kitsch.zip
HILLY MICHAELS - Calling All Girls.zip
HILLY MICHAELS- Lumia.zip
HUDSON - Damn Those Kids.zip
HUDSON BROTHERS - Ba Fa.zip
JIGSAW - Jigsaw.zip
MAYDAY - Mayday (AOR).zip
MIKE PATTO - Voice of the People.zip
MISSOURI - Missouri.zip
NANTUCKET - Best Of.zip
NUMBERS - Add Up.zip
ORBIT - Orbit (1973).zip
ORIGINAL MIRRORS - Original Mirrors.zip
PAGLIARO - Rainshowers.zip
PEZBAND - The Dee Harris Songbook.zip
PIPER - Can't Wait.zip
PIPER - Piper.zip
REDDY TEDDY - Reddy Teddy.zip
REGGIE KNIGHTON - Reggie Knighton.zip
REX - Misc Trax from _Rex_ & _Where Do We Go From Here_.zip
RICK DERRINGER - Whisky-A-Go-Go February 1977.zip
ROADMASTER - Sweet Music.zip
ROBERT HAZZARD - Vinyl EP & Wing Of Fire (Vinyl).zip
ROBIN TROWER - Winterland 1975.zip
ROCKIN' HORSE - Yes It Is.zip
SHANE CHAMPAGNE BAND - EP.zip
SHERBERT - Howzat.zip
SLEEPY HOLLOW - Sleepy Hollow.zip
SPARKS - Bottom Line New York City December 1976.zip
STRAIGHT EIGHT - Shuffle 'n' Cut.zip
STRAY - Stray.zip
STRIDE & PLAIN - New Guitars In Town.zip
SUSAN - Falling In Love Again & Live at the Rat Tracks.zip
TALKING HEADS - CBS Demos 1975.zip
TARGET - Target.zip
THE ARCHIES - Everythings Archie.zip
THE BOYZZ - Too Wild Too Tame.zip
THE COLORS - Rave It Up EP.zip
THE DODGERS - Love On The Rebound.zip
THE FLAME - The Flame.zip
THE FLYING CIRCUS - The Flying Circus.zip
THE FOOLS - HEAVY MENTAL.zip
THE FOOLS - Sold Out.zip
THE KIDS - Pop N Roll With The Kids.zip
THE MOTORS - BBC Radio 1 In Concert 1978.zip
THE NAUTS & SUPERNAUT - The Complete Collection.zip
THE NECESSARIES - Event Horizon.zip
THE PRIME MOVERS - Matters Of Time.zip
THE PRODUCERS - Demos 1983.zip
THE REAL KIDS - Demos 1977.zip
THE RECORDS - Man with a Girlproof Heart.zip
THE ROLLERS - Voxx.zip
THE RUMOUR - Max.zip
THE SPECTRES - Stories EP.zip
THE X-TEENS - The X-Teens.zip
THUNDERMUG - Thundermug.zip
TOM DICKIE & THE DESIRES - Competition.zip
TOMMY TUTONE - National Emotion (1983).zip
TRICKSTER - Trickster.zip
TRILLION - Misc Trax.zip
TROOPER - Trooper.zip
TYLA GANG - Yachtless.zip
VANCE OR TOWERS - Vance Or Towers.zip
V_A - Deep Rare 80s Power Pop.zip
V_A - Powerpop To The People Vol 1 (1970-1986).zip
V_A - Psychedelic Promos and Radio V.3.zip
WEREWOLVES - Misc Trax & Live.zip
WILL BIRCH - Country Rock Overview.zip
Z-ROCKS (1981).zip
ZONES - We're No Angels.zip
ZZ - Surprise Misc Trax.zip
